#ADC
set_input_pin	KEYWORD2
get_data	KEYWORD2

#IMU
#functies
sensors_config	KEYWORD2
int_gen	KEYWORD2
set_int	KEYWORD2
get_int	KEYWORD2
print_resolt_IMU	KEYWORD2
convert_data	KEYWORD2
get_data	KEYWORD2
#constanten
ODR_set	LITERAL1
g_set	LITERAL1
dps_set	LITERAL1
int_def	LITERAL1
interupt_lation	LITERAL1

#IO expander
#functies
get_output	KEYWORD2
set_output	KEYWORD2
#constanten
input__port_ADDR	LITERAL1
output_port_ADDR	LITERAL1
IO_dir_port_ADDR	LITERAL1
PUL_EN_port_ADDR	LITERAL1
PULDIR_port_ADDR	LITERAL1
INT_EN_port_ADDR	LITERAL1
INT_SR_port_ADDR	LITERAL1

#IR_afstandsensor
#functies
read_IR_sensor	KEYWORD2
#constanten
IR_L	LITERAL1
IR_C	LITERAL1
IR_R	LITERAL1

#LCD
set_cursor	KEYWORD2
clear_screen	KEYWORD2
backlight	KEYWORD2
print_char	KEYWORD2
print_text	KEYWORD2

#lijnsensor
#functies
get_all_spectrum	KEYWORD2
set_FD_persistence	KEYWORD2
set_int_chanel	KEYWORD2
set_GPIO	KEYWORD2
ENABLE	KEYWORD2
set_ADC_timing	KEYWORD2
set_wait	KEYWORD2
set_power	KEYWORD2
set_ADC_gain	KEYWORD2
sleep_after_int	KEYWORD2
fifo_th	KEYWORD2
led_config	KEYWORD2
set_pers	KEYWORD2
set_config20	KEYWORD2
set_ADC_FD_max_gain	KEYWORD2
set_AZ_config	KEYWORD2
fifo_flicker_detect	KEYWORD2
set_FD_timing	KEYWORD2
smux_cmd	KEYWORD2
control	KEYWORD2
fifo_map	KEYWORD2
write_fifo	KEYWORD2
uint16_t read_fifo	KEYWORD2
spectrum get_spectrum	KEYWORD2
uint16_t get_ID	KEYWORD2
uint64_t get_status	KEYWORD2
set_sensor	KEYWORD2
set_register	KEYWORD2
set_REG_BANK	KEYWORD2
get_byte_buff	KEYWORD2
#constanten
sensors	KEYWORD1
FD_starus	KEYWORD1
#structs
spectrum	LITERAL1

#machnetometer
print_resolt_machnetomerter	KEYWORD2
start_burst_mode	KEYWORD2
change_raw_to_T	KEYWORD2
convert_data	KEYWORD2
get_data_machnetometer	KEYWORD2

#motor
get_encoder1	KEYWORD2
get_encoder2	KEYWORD2
get_snelheid1	KEYWORD2
get_snelheid2	KEYWORD2
get_volt	KEYWORD2
get_stroom1	KEYWORD2
get_stroom2	KEYWORD2
get_versnelling	KEYWORD2
get_mode	KEYWORD2
set_acceleration	KEYWORD2
set_mode	KEYWORD2
set_regulator	KEYWORD2
set_time_out	KEYWORD2
reset_encoders	KEYWORD2
set_snelheid1	KEYWORD2
set_snelheid2	KEYWORD2

#ESP addon
init	KEYWORD2
#structs	KEYWORD1
int16_3	KEYWORD1
float_3	KEYWORD1
return_IMU	KEYWORD1
return_machnetometer	KEYWORD1
float_IMU	KEYWORD1
converted_machnetometer	KEYWORD1
ArduinoOTA	KEYWORD1

#servo
#functies
init_servo	KEYWORD2
set_pos	KEYWORD2
set_ofset	KEYWORD2
#constanten
Hooft_horizontaal	LITERAL1
Hooft_vertikaal	LITERAL1
Grip_L	LITERAL1
Grip_R	LITERAL1
alles_af	LITERAL1
hooft_aan	LITERAL1
grips_aan	LITERAL1
alles_aan	LITERAL1

#US afstands sensor
US_afstands_sensor	KEYWORD2